{
  "id": "village",
  "name": "Villaggio",
  "asset": "./village.png",
  "layout": {
    "cols": 59,
    "rows": 39,
    "tileSize": 26
  },
  "collisionMap": {
    "legend": {
      ".": "PATH",
      "#": "TREE"
    },
    "spawn": {
      "x": 14,
      "y": 18,
      "facing": "down"
    },
    "rows": [
      "###########################################################",
      "###########################################################",
      "###########################################################",
      "###########################################################",
      "###########################################################",
      "###########################################################",
      "###########################################################",
      "###########################################################",
      "###################...#####################################",
      "#################..................########################",
      "#################........###################...############",
      "###################..#######################...############",
      "###################..#############................#########",
      "##################................................#########",
      "#############......................##########..############",
      "#########..........##########################..############",
      "##############..#############################..############",
      "###########.....#############################..############",
      "###########.........#########################..############",
      "#####.#####......................#######.......############",
      "#####........####.........#####...######.......####..######",
      "#####........#.##....##########....#####.............######",
      "###########........................##########...........###",
      "###########........................##########..############",
      "###########........................######......############",
      "####################...............######......############",
      "#########################..##################..############",
      "#########################..##################..############",
      "#########################..##################..############",
      "#########################..###########################..###",
      "#########################..#######..##################..###",
      "#########################..#######......##############..###",
      "#######.....................................##########..###",
      "#######.................................................###",
      "#############....#########################..............###",
      "#############....###########################............###",
      "#############################################...........###",
      "###########################################################",
      "###########################################################"
    ]
  },
  "points": {
    "interactionPoints": [
      {
        "id": "fountain",
        "x": 8,
        "y": 6,
        "text": "Fontana antica: l'acqua e' fredda e pulita."
      },
      {
        "id": "bonfire",
        "x": 4,
        "y": 11,
        "text": "Falo del clan: senti odore di legna e spezie."
      },
      {
        "id": "totem",
        "x": 20,
        "y": 4,
        "text": "Totem teschio: un simbolo di protezione tribale."
      }
    ],
    "healTile": {
      "x": 8,
      "y": 6,
      "label": "Fontana",
      "text": "Ti riposi un momento."
    }
  }
}